CRS,REGIAO_SAU,MUNICIPIOS,TOTAL_DOSES_LIBERADAS,TRAB_SAUDE_75,TRAB_SAUDE_75_VAC_D1,TRAB_SAUDE_75_VAC_D2,INDIGENAS,INDIGENAS_VAC_D1,INDIGENAS_VAC_D2,MAIOR_60,MAIOR_60_VAC_D1,MAIOR_60_VAC_D2,IDOSOS_90e,IDOSOS_90e_VAC_D1,IDOSOS_90e_VAC_D2,META_1a_FASE,TOTAL_VAC_D1,TOTAL_VAC_D2,TOTAL_VAC,TOTAL_VAC_SIPNI,FUN_BUT,FUN_OSW,DoA,DoB
6 CRS,TOCANTINS,ABAETETUBA,3062,1610,1747,0,0,0,0,0,0,0,1946,175,0,3610,1922,0,1922,1455,934,521,1455,0
11 CRS,CARAJAS,ABEL FIGUEIREDO,163,97,87,0,0,0,0,0,0,0,97,0,0,179,87,0,87,73,34,39,73,0
2 CRS,METROPOLITANA II,ACARA,647,376,324,0,0,0,0,0,2,0,551,0,0,866,326,0,326,355,211,144,355,0
7 CRS,MARAJO I,AFUA,798,333,315,0,0,0,0,0,0,0,335,120,0,666,435,0,435,314,205,109,313,1
12 CRS,ARAGUAIA,AGUA AZUL DO NORTE,340,156,135,0,0,0,0,0,0,0,117,0,0,318,135,0,135,138,98,40,138,0
9 CRS,BAIXO AMAZONAS,ALENQUER,1584,521,391,147,0,0,0,7,0,0,821,571,0,1277,962,147,1109,1048,392,656,909,139
9 CRS,BAIXO AMAZONAS,ALMEIRIM,1510,282,303,25,614,369,0,0,0,0,319,183,0,1241,855,25,880,525,215,310,485,40
10 CRS,XINGU,ALTAMIRA,7874,3116,2308,255,3294,481,0,0,0,0,1241,117,0,6552,2906,255,3161,1961,1108,853,1960,1
8 CRS,MARAJO II,ANAJAS,440,184,190,40,0,0,0,0,0,0,214,70,0,372,260,40,300,257,177,80,225,32
1 CRS,METROPOLITANA I,ANANINDEUA,11990,7679,6505,1334,0,0,0,11,20,16,5466,3572,0,11827,10097,1350,11447,3877,3877,0,3876,1
10 CRS,XINGU,ANAPU,416,255,154,13,386,193,0,0,0,0,162,1,0,771,348,13,361,347,326,21,340,7
4 CRS,RIO CAETES,AUGUSTO CORREA,603,338,324,0,0,0,0,0,0,0,463,48,0,766,372,0,372,372,231,141,346,26
5 CRS,METROPOLITANA III,AURORA DO PARA,390,195,201,0,28,0,0,0,0,0,279,0,0,508,201,0,201,191,115,76,191,0
9 CRS,TAPAJOS,AVEIRO,1030,124,116,30,490,194,0,0,0,0,220,80,0,815,390,30,420,323,274,49,307,16
8 CRS,MARAJO II,BAGRE,428,207,204,96,0,0,0,0,0,0,153,20,0,335,224,96,320,215,124,91,215,0
13 CRS,TOCANTINS,BAIAO,758,327,241,90,39,0,0,0,0,0,398,0,0,722,241,90,331,216,154,62,216,0
12 CRS,ARAGUAIA,BANNACH,302,74,65,0,90,0,0,0,0,0,46,0,0,200,65,0,65,49,30,19,49,0
6 CRS,TOCANTINS,BARCARENA,2852,1866,1608,206,0,0,0,0,1,0,952,261,0,2512,1870,206,2076,1918,1180,738,1768,150
1 CRS,METROPOLITANA I,BELEM,67670,48613,17496,0,0,0,0,172,264,0,26178,11871,0,60629,29631,0,29631,15785,15785,0,15784,1
9 CRS,BAIXO AMAZONAS,BELTERRA,1196,128,137,,307,0,0,0,0,0,312,220,0,772,357,0,357,208,179,29,208,0
1 CRS,METROPOLITANA I,BENEVIDES,943,600,523,83,0,0,0,0,0,0,623,42,0,1099,565,83,648,642,642,0,534,108
11 CRS,CARAJAS,BOM JESUS DO TOCANTINS,1356,193,183,0,507,326,0,0,0,0,199,0,0,871,508,0,508,226,145,81,225,1
4 CRS,RIO CAETES,BONITO,204,135,123,18,0,0,0,0,0,0,149,0,0,244,123,18,141,130,64,66,118,12
4 CRS,RIO CAETES,BRAGANCA,2569,1581,1471,616,0,0,0,0,0,0,1579,115,0,2889,1586,616,2202,2143,1498,645,1572,571
10 CRS,XINGU,BRASIL NOVO,328,177,119,0,0,0,0,0,0,0,226,5,0,384,124,0,124,114,60,54,114,0
11 CRS,CARAJAS,BREJO GRANDE DO ARAGUAIA,150,90,95,0,0,0,0,0,0,0,110,5,0,181,100,0,100,83,42,41,83,0
11 CRS,LAGO TUCURUI,BREU BRANCO,633,414,322,0,0,0,0,5,5,0,549,10,0,838,337,0,337,325,162,163,325,0
8 CRS,MARAJO II,BREVES,2234,1136,1005,340,0,0,0,0,0,0,1039,427,0,1831,1432,340,1772,1544,1094,450,1427,117
2 CRS,METROPOLITANA II,BUJARU,299,168,164,0,0,0,0,0,0,0,323,0,0,456,164,0,164,166,85,81,166,0
7 CRS,MARAJO I,CACHOEIRA DO ARARI,482,193,143,40,0,0,0,0,0,0,133,30,0,230,173,40,213,187,107,80,158,29
4 CRS,RIO CAETES,CACHOEIRA DO PIRIA,329,158,155,0,0,0,0,0,0,0,355,7,0,545,162,0,162,150,106,44,150,0
13 CRS,TOCANTINS,CAMETA,2143,1261,1196,425,0,0,0,0,0,0,1696,0,0,2751,1196,425,1621,775,544,231,775,0
11 CRS,CARAJAS,CANAA DOS CARAJAS,1103,706,655,0,16,0,0,0,0,0,154,0,0,741,655,0,655,628,339,289,628,0
4 CRS,RIO CAETES,CAPANEMA,2684,1626,1295,41,0,0,0,19,19,15,1161,43,0,2607,1357,56,1413,1323,990,333,1282,41
5 CRS,METROPOLITANA III,CAPITAO POCO,1016,692,551,164,0,0,0,0,0,0,718,53,0,1234,604,164,768,1236,995,241,1033,203
3 CRS,METROPOLITANA III,CASTANHAL,4606,2683,2976,0,0,0,0,38,0,0,2282,0,0,4784,2976,0,2976,3038,2118,920,2468,570
7 CRS,MARAJO I,CHAVES,432,192,149,0,0,0,0,0,0,0,223,7,0,365,156,0,156,145,72,73,145,0
2 CRS,METROPOLITANA II,COLARES,245,129,119,0,0,0,0,0,0,0,246,0,0,357,119,0,119,113,62,51,113,0
12 CRS,ARAGUAIA,CONCEICAO DO ARAGUAIA,1846,1017,908,7,0,0,0,10,0,0,836,240,0,1700,1148,7,1155,1154,747,407,1063,91
2 CRS,METROPOLITANA II,CONCORDIA DO PARA,429,249,236,89,0,0,0,0,0,0,345,29,0,556,265,89,354,281,187,94,250,31
12 CRS,ARAGUAIA,CUMARU DO NORTE,1772,111,141,2,816,10,0,0,0,0,35,0,0,975,151,2,153,65,56,9,65,0
11 CRS,CARAJAS,CURIONOPOLIS,361,188,164,0,0,0,0,0,5,0,323,2,0,482,171,0,171,124,71,53,124,0
8 CRS,MARAJO II,CURRALINHO,512,205,195,84,0,0,0,0,0,0,281,90,0,448,285,84,369,353,265,88,272,81
9 CRS,BAIXO AMAZONAS,CURUA,266,113,95,25,0,0,0,0,0,0,125,105,0,210,200,25,225,165,45,120,165,0
3 CRS,METROPOLITANA III,CURUCA,696,381,508,0,0,0,0,0,0,0,753,0,0,1062,508,0,508,508,348,160,349,159
5 CRS,CARAJAS,DOM ELISEU,842,404,350,15,0,0,0,0,0,0,415,13,0,929,363,15,378,345,200,145,314,31
11 CRS,CARAJAS,ELDORADO DOS CARAJAS,383,216,225,0,0,0,0,0,0,0,283,8,0,470,233,0,233,205,120,85,202,3
9 CRS,BAIXO AMAZONAS,FARO,334,165,163,0,0,0,0,0,0,0,96,92,0,248,255,0,255,274,145,129,232,42
12 CRS,ARAGUAIA,FLORESTA DO ARAGUAIA,434,257,135,14,0,0,0,0,0,0,199,0,0,429,135,14,149,141,90,51,136,5
5 CRS,METROPOLITANA III,GARRAFAO DO NORTE,738,246,280,18,0,0,0,0,0,0,296,9,0,802,289,18,307,302,247,55,285,17
11 CRS,LAGO TUCURUI,GOIANESIA DO PARA,608,296,273,0,42,39,0,0,0,0,276,0,0,598,312,0,312,166,166,0,166,0
8 CRS,MARAJO II,GURUPA,312,295,328,118,0,0,0,0,0,0,284,99,0,620,427,118,545,313,192,121,313,0
3 CRS,METROPOLITANA III,IGARAPE-ACU,701,390,374,0,0,0,0,0,0,0,614,0,0,948,374,0,374,374,189,185,374,0
6 CRS,TOCANTINS,IGARAPE-MIRI,942,524,489,26,0,0,0,0,0,0,814,80,0,1280,569,26,595,574,366,208,545,29
3 CRS,METROPOLITANA III,INHANGAPI,191,122,141,0,0,0,0,0,0,0,152,0,0,241,141,0,141,141,91,50,108,33
5 CRS,METROPOLITANA III,IPIXUNA DO PARA,774,571,415,66,0,0,0,0,0,0,252,14,0,639,429,66,495,464,253,211,412,52
5 CRS,METROPOLITANA III,IRITUIA,524,201,261,0,0,0,0,0,0,0,534,0,0,806,261,0,261,317,239,78,256,61
9 CRS,TAPAJOS,ITAITUBA,4199,1406,1206,0,672,219,0,29,26,0,1032,537,0,2955,1989,0,1989,1602,1415,187,1598,4
11 CRS,CARAJAS,ITUPIRANGA,1471,426,335,0,283,0,0,13,12,0,470,36,0,1077,383,0,383,380,230,150,360,20
9 CRS,TAPAJOS,JACAREACANGA,9742,219,84,0,4964,1150,79,0,0,0,34,23,0,5185,1257,79,1336,433,433,0,432,1
11 CRS,LAGO TUCURUI,JACUNDA,736,417,336,0,42,0,0,0,0,0,556,0,0,886,336,0,336,294,159,135,294,0
9 CRS,BAIXO AMAZONAS,JURUTI,1392,598,576,169,0,0,0,0,0,0,496,366,0,1032,942,169,1111,358,139,219,358,0
13 CRS,TOCANTINS,LIMOEIRO DO AJURU,437,287,238,51,0,0,0,0,0,0,286,0,0,490,238,51,289,211,122,89,210,1
5 CRS,METROPOLITANA III,MAE DO RIO,580,419,330,93,0,0,0,0,0,0,418,3,0,675,333,93,426,431,280,151,327,104
3 CRS,METROPOLITANA III,MAGALHAES BARATA,150,76,74,0,0,0,0,0,0,0,160,0,0,229,74,0,74,79,50,29,67,12
11 CRS,CARAJAS,MARABA,5492,3758,3074,0,0,0,0,25,43,0,2173,112,0,4971,3229,0,3229,580,12,568,580,0
3 CRS,METROPOLITANA III,MARACANA,485,249,229,0,0,0,0,0,0,0,548,0,0,766,229,0,229,207,124,83,207,0
3 CRS,METROPOLITANA III,MARAPANIM,750,431,473,0,0,0,0,0,0,0,590,0,0,958,473,0,473,471,277,194,467,4
1 CRS,METROPOLITANA I,MARITUBA,2251,1060,1154,470,0,0,0,43,43,38,929,56,0,2262,1253,508,1761,1699,1699,0,1239,460
10 CRS,XINGU,MEDICILANDIA,379,229,233,85,0,0,0,7,7,0,254,1,0,432,241,85,326,282,171,111,226,56
8 CRS,MARAJO II,MELGACO,522,288,218,33,0,0,0,0,0,0,129,62,0,375,280,33,313,314,235,79,282,32
13 CRS,TOCANTINS,MOCAJUBA,482,288,217,29,0,0,0,0,0,0,463,0,0,677,217,29,246,204,124,80,203,1
6 CRS,TOCANTINS,MOJU,858,394,322,0,87,69,0,0,0,0,668,38,0,1062,430,0,430,243,211,32,243,0
9 CRS,BAIXO AMAZONAS,MOJUI DOS CAMPOS,464,115,133,0,0,0,0,0,0,0,261,204,0,387,337,0,337,0,0,0,0,0
9 CRS,BAIXO AMAZONAS,MONTE ALEGRE,1596,426,383,163,0,0,0,0,0,0,951,818,0,1333,1201,163,1364,1037,294,743,1030,7
7 CRS,MARAJO I,MUANA,588,220,210,0,0,0,0,0,0,0,360,280,0,542,490,0,490,237,141,96,237,0
5 CRS,METROPOLITANA III,NOVA ESPERANCA DO PIRIA,254,148,145,0,0,0,0,0,0,0,129,0,0,267,145,0,145,189,129,60,141,48
11 CRS,CARAJAS,NOVA IPIXUNA,250,144,135,1,0,0,0,0,0,0,165,16,0,287,151,1,152,138,86,52,137,1
4 CRS,RIO CAETES,NOVA TIMBOTEUA,304,180,162,40,0,0,0,0,0,0,301,0,0,431,162,40,202,35,35,0,35,0
9 CRS,TAPAJOS,NOVO PROGRESSO,1842,270,370,38,0,0,0,0,0,0,96,28,0,305,398,38,436,328,215,113,288,40
11 CRS,LAGO TUCURUI,NOVO REPARTIMENTO,2314,690,489,0,443,0,0,0,0,0,536,0,0,1587,489,0,489,463,320,143,463,0
9 CRS,BAIXO AMAZONAS,OBIDOS,2999,381,412,78,1259,404,0,0,0,0,734,529,0,2414,1345,78,1423,660,212,448,660,0
13 CRS,TOCANTINS,OEIRAS DO PARA,469,268,260,83,0,0,0,0,0,0,285,0,0,528,260,83,343,155,112,43,145,10
9 CRS,BAIXO AMAZONAS,ORIXIMINA,4855,765,683,0,1519,1411,0,0,0,0,814,771,0,2911,2865,0,2865,2262,1487,775,2259,3
4 CRS,RIO CAETES,OUREM,265,152,142,50,0,0,0,0,0,0,283,40,0,396,182,50,232,64,64,0,64,0
12 CRS,ARAGUAIA,OURILANDIA DO NORTE,2950,680,665,9,929,63,0,4,4,0,166,0,0,1661,732,9,741,259,243,16,228,31
10 CRS,XINGU,PACAJA,528,369,214,28,0,0,0,0,0,0,377,12,0,619,226,28,254,194,124,70,194,0
11 CRS,CARAJAS,PALESTINA DO PARA,162,92,92,0,0,0,0,0,0,0,112,10,0,185,102,0,102,101,62,39,101,0
5 CRS,METROPOLITANA III,PARAGOMINAS,4077,1611,1450,470,612,494,0,18,18,0,690,48,0,2711,2010,470,2480,1448,902,546,1436,12
11 CRS,CARAJAS,PARAUAPEBAS,6015,2623,2384,0,1057,1,0,17,17,0,808,20,0,4021,2422,0,2422,2019,983,1036,2017,2
12 CRS,ARAGUAIA,PAU D ARCO,554,117,59,2,188,6,0,0,0,0,73,1,0,360,66,2,68,50,40,10,48,2
4 CRS,RIO CAETES,PEIXE-BOI,159,72,72,10,0,0,0,0,0,0,178,0,0,247,72,10,82,0,0,0,0,0
11 CRS,CARAJAS,PICARRA,210,112,116,0,0,0,0,0,0,0,124,0,0,230,116,0,116,108,61,47,108,0
9 CRS,BAIXO AMAZONAS,PLACAS,492,244,197,0,0,0,0,0,0,0,150,140,0,345,337,0,337,199,128,71,197,2
7 CRS,MARAJO I,PONTA DE PEDRAS,568,202,198,65,0,0,0,0,0,0,352,149,0,516,347,65,412,412,322,90,345,67
8 CRS,MARAJO II,PORTEL,820,318,315,110,0,0,0,0,0,0,428,91,0,726,406,110,516,294,166,128,294,0
10 CRS,XINGU,PORTO DE MOZ,456,311,260,18,7,6,0,0,0,0,250,13,0,479,279,18,297,250,135,115,250,0
9 CRS,BAIXO AMAZONAS,PRAINHA,636,211,226,78,0,0,0,0,0,0,287,283,0,502,509,78,587,543,235,308,471,72
4 CRS,RIO CAETES,PRIMAVERA,270,195,147,60,0,0,0,0,0,0,242,0,0,346,147,60,207,143,60,83,143,0
4 CRS,RIO CAETES,QUATIPURU,206,85,101,32,0,0,0,0,0,0,218,0,0,317,101,32,133,98,55,43,98,0
12 CRS,ARAGUAIA,REDENCAO,2782,1493,1507,170,50,28,0,13,38,0,969,0,0,2260,1573,170,1743,1444,905,539,1276,168
12 CRS,ARAGUAIA,RIO MARIA,428,255,153,10,0,0,0,0,0,0,222,0,0,440,153,10,163,151,56,95,143,8
11 CRS,CARAJAS,RONDON DO PARA,723,421,389,0,0,0,0,0,0,0,528,0,0,883,389,0,389,360,198,162,360,0
9 CRS,TAPAJOS,RUROPOLIS,878,356,351,114,0,0,0,0,0,0,337,160,0,658,511,114,625,583,444,139,487,96
4 CRS,RIO CAETES,SALINOPOLIS,633,350,339,0,0,0,0,0,0,0,476,0,0,797,339,0,339,335,188,147,329,6
7 CRS,MARAJO I,SALVATERRA,452,127,135,0,0,0,0,0,0,0,321,29,0,437,164,0,164,157,92,65,157,0
1 CRS,METROPOLITANA I,SANTA BARBARA DO PARA,378,214,235,1,0,0,0,0,0,0,236,6,0,427,241,1,242,292,292,0,223,69
7 CRS,MARAJO I,SANTA CRUZ DO ARARI,236,53,109,0,0,0,0,0,0,0,98,45,0,208,154,0,154,94,62,32,94,0
2 CRS,METROPOLITANA II,SANTA ISABEL DO PARA,1275,755,645,161,0,0,0,0,45,0,794,101,0,1454,791,161,952,833,572,261,707,126
4 CRS,RIO CAETES,SANTA LUZIA DO PARA,1366,136,195,77,453,479,0,0,0,0,315,42,0,950,716,77,793,303,243,60,220,83
12 CRS,ARAGUAIA,SANTA MARIA DAS BARREIRAS,461,278,128,0,36,0,0,0,0,0,209,0,0,470,128,0,128,114,114,0,114,0
5 CRS,METROPOLITANA III,SANTA MARIA DO PARA,1098,308,211,151,287,159,0,0,0,0,424,0,0,983,370,151,521,362,280,82,362,0
12 CRS,ARAGUAIA,SANTANA DO ARAGUAIA,708,338,490,0,27,30,0,13,13,0,349,0,0,724,533,0,533,156,118,38,156,0
9 CRS,BAIXO AMAZONAS,SANTAREM,20206,6646,3404,930,3756,1810,0,30,30,0,4070,2344,0,12418,7588,930,8518,3687,2416,1271,3686,1
4 CRS,RIO CAETES,SANTAREM NOVO,136,74,68,20,0,0,0,0,0,0,98,9,0,162,77,20,97,65,36,29,65,0
2 CRS,METROPOLITANA II,SANTO ANTONIO DO TAUA,428,245,203,0,0,0,0,0,0,0,363,0,0,572,203,0,203,182,101,81,181,1
2 CRS,METROPOLITANA II,SAO CAETANO DE ODIVELAS,264,114,133,0,0,0,0,0,0,0,294,0,0,421,133,0,133,127,72,55,127,0
11 CRS,CARAJAS,SAO DOMINGOS DO ARAGUAIA,499,232,222,0,26,0,0,0,0,0,461,0,0,680,222,0,222,211,106,105,211,0
3 CRS,METROPOLITANA III,SAO DOMINGOS DO CAPIM,462,288,273,0,0,0,0,0,0,0,349,0,0,562,273,0,273,271,150,121,271,0
12 CRS,ARAGUAIA,SAO FELIX DO XINGU,2630,706,495,10,1046,7,0,19,17,2,330,0,0,1998,519,12,531,410,277,133,410,0
3 CRS,METROPOLITANA III,SAO FRANCISCO DO PARA,372,204,198,0,0,0,0,0,0,0,292,0,0,471,198,0,198,190,101,89,190,0
11 CRS,CARAJAS,SAO GERALDO DO ARAGUAIA,946,319,150,0,235,166,0,0,0,0,351,0,0,802,316,0,316,129,111,18,129,0
3 CRS,METROPOLITANA III,SAO JOAO DA PONTA,119,67,61,0,0,0,0,0,0,0,103,0,0,154,61,0,61,59,29,30,59,0
4 CRS,RIO CAETES,SAO JOAO DE PIRABAS,361,193,182,40,0,0,0,0,0,0,404,75,0,564,257,40,297,190,110,80,188,2
11 CRS,CARAJAS,SAO JOAO DO ARAGUAIA,312,180,107,0,0,0,0,0,0,0,185,0,0,346,107,0,107,100,90,10,100,0
5 CRS,METROPOLITANA III,SAO MIGUEL DO GUAMA,890,437,478,137,0,0,0,0,0,0,747,0,0,1204,478,137,615,444,263,181,444,0
7 CRS,MARAJO I,SAO SEBASTIAO DA BOA VISTA,576,183,223,0,0,0,0,0,0,0,307,63,0,523,286,0,286,264,183,81,264,0
12 CRS,ARAGUAIA,SAPUCAIA,184,88,126,0,0,0,0,15,7,0,48,0,0,145,133,0,133,65,43,22,65,0
10 CRS,XINGU,SENADOR JOSE PORFIRIO,214,150,129,21,254,144,0,0,0,0,61,6,0,430,279,21,300,276,224,52,276,0
7 CRS,MARAJO I,SOURE,552,84,241,90,0,0,0,0,0,0,373,284,0,567,525,90,615,521,485,36,424,97
6 CRS,LAGO TUCURUI,TAILANDIA,1098,616,650,0,0,0,0,0,0,0,453,11,0,1072,661,0,661,562,394,168,561,1
3 CRS,METROPOLITANA III,TERRA ALTA,198,102,123,0,0,0,0,0,0,0,184,0,0,269,123,0,123,123,74,49,98,25
9 CRS,BAIXO AMAZONAS,TERRA SANTA,536,237,181,40,0,0,0,0,0,0,241,180,0,413,361,40,401,336,98,238,336,0
2 CRS,METROPOLITANA II,TOME-ACU,1826,595,587,140,250,200,0,4,4,4,675,10,0,1488,800,144,944,769,645,124,622,147
4 CRS,RIO CAETES,TRACUATEUA,585,241,295,50,0,0,0,0,0,0,414,0,0,756,295,50,345,331,244,87,283,48
9 CRS,TAPAJOS,TRAIRAO,514,152,153,26,93,88,49,0,0,0,107,65,0,337,306,75,381,281,217,64,250,31
12 CRS,ARAGUAIA,TUCUMA,1068,703,196,0,0,0,0,0,0,0,301,1,0,885,197,0,197,244,244,0,216,28
11 CRS,LAGO TUCURUI,TUCURUI,3307,1867,1976,0,267,147,0,13,13,0,869,57,0,2600,2193,0,2193,1718,1151,567,1714,4
5 CRS,METROPOLITANA III,ULIANOPOLIS,847,543,406,0,0,0,0,0,0,0,281,7,0,779,413,0,413,385,285,100,385,0
10 CRS,XINGU,URUARA,656,385,369,0,0,0,0,0,0,0,344,14,0,695,383,0,383,254,213,41,254,0
2 CRS,METROPOLITANA II,VIGIA,849,430,331,0,0,0,0,0,0,0,750,0,0,1177,331,0,331,231,115,116,231,0
4 CRS,RIO CAETES,VISEU,890,479,462,35,0,0,0,0,0,0,641,25,0,1095,487,35,522,406,246,160,406,0
10 CRS,XINGU,VITORIA DO XINGU,444,293,269,0,221,198,0,0,0,0,128,14,0,592,481,0,481,456,344,112,456,0
12 CRS,ARAGUAIA,XINGUARA,1156,713,517,0,0,0,0,8,12,12,418,17,0,1047,546,12,558,623,445,178,505,118
